###############
#...o.....o...#
#......K3.....#
#......@......#
#...o.....o...#
#.............#
#.............#
#......1......#
######===######
     #.c.#      #########
     #...#      #E.....E#
     #===#      #.......#
   ###.2.########...E...#
   #E...............E...#
   ##.####.######.......#
   #EEEEEEE#    #E.....E#
   #########    #########

