###############
#...c.........#
#.....#....#..#
#..........##.#
#.##########..#
#.........m..##
#............#
#@...........#
##############
