###############
#...c.....@...#
#.............#
#.............#
#.............#
#.............#
#.............#
#e.....!.....e#
###############
