#######
#..mc.#
#..@..#
#.....#
#######
