############
#..mc.#.@..#
#.....#....#
#..........#
############
