#######
#.....#
#..c..#
#.....#
###.###
  #.#
  #.#
  #.#
  ###
