###############
#...c.#.......#
#.....#....#..#
#..........##.#
############..#
#..m.........##
#............#
#@...........#
##############
