#######
#..c..#
#..@..#
#.....#
#######
