#######
#..c..#
#..@..#
#.....#
###.###
  #.#
  #.#
  #.#
  ###
